10,0,0,0,10,10,10,10,10,10,10,0,0,0,0,14,14,0,0,0,0,0,0,0,0,0
10,0,0,0,0,0,0,0,0,0,0,0,0,0,0,14,14,0,0,0,0,0,0,0,0,0
10,0,0,0,0,0,0,0,0,0,0,0,0,0,0,14,14,0,0,0,0,0,0,0,0,0
10,0,0,0,0,0,0,0,0,0,0,0,0,0,0,14,14,0,0,0,0,0,0,0,0,0
10,0,0,0,0,0,0,0,0,0,0,0,0,0,0,14,14,0,0,0,0,0,0,0,0,0
10,0,0,0,0,6,6,6,6,6,0,0,0,0,0,14,14,0,0,0,0,0,0,0,0,0
10,0,0,0,0,0,0,0,0,0,0,0,0,0,0,14,14,0,0,0,0,0,0,0,0,0
10,0,0,0,6,6,6,6,6,6,6,0,0,0,0,14,14,0,0,0,0,0,0,0,0,0
10,0,0,0,0,0,0,0,0,0,0,0,0,0,0,14,14,0,0,0,0,0,0,0,0,0
10,0,0,0,6,6,6,6,6,6,6,0,0,0,0,14,14,0,0,0,0,0,0,0,0,0
10,0,0,0,10,10,10,10,10,10,10,0,0,0,0,14,14,0,0,0,0,0,0,0,0,0
10,0,0,0,10,10,10,10,10,10,10,0,0,18,18,22,22,0,0,0,0,0,0,0,0,0
10,0,0,0,10,10,10,10,10,10,10,0,0,18,18,22,22,0,0,0,0,0,0,0,0,0
1,1,1,1,1,1,1,1,1,1,1,1,1,1,1,1,1,1,1,1,1,1,1,1,1,1
1,1,1,1,1,1,1,1,1,1,1,1,1,1,1,1,1,1,1,1,1,1,1,1,1,1
